5
6
*
O
S
^
******
*OSOO*
*OOOO*
**OOO*
*^****
