13
11
*
O
S
^
***********
*****S*****
*OOOOOOOOO*
*OOOOOOOOO*
*OOOOOOOOO*
*OOOOOOOOO*
*OOOOOOOOO*
*OOOOOOOOO*
*OOOOOOOOO*
*OOOOOOOOO*
*****O*****
***********
*****^*****
