5
6
*
O
S
^
******
*OOO**
*S*O**
*OOOO*
****^*
