13
11
*
O
S
^
***********
*****S*****
*OOOOOOOOO*
*****O*****
**OOOOOOO**
**O**O**O**
**OOOO**O**
*****OOOO**
*****O*****
*OOOOOOOO**
*****O*****
*****O*****
*****^*****
