5
6
*
O
S
^
******
**OO**
*S*O**
*O****
*^****
